11111111111111111111111111111111
1000000000P000000C001100100CCC01
100000X0000000011110000010000001
1111100111111000001000C011111001
1000000000C0100000110010000X0001
100011111000100C0001000001111111
10C010000X00000000000000E1111111
11111111111111111111111111111111