11111111111
11111111111
1PC000000E1
11111111111
11111111111
