1111111
100P001
1000001
1000C01
100E001
1000001
1111111