11111111
100P0001
10000001
1E001001
1001C101
10001001
11111111