111111111111111111
1P0000000000C00001
10C0E0000000000001
100000000000C00001
100C00000000C00001
100000C00000000001
111111111111111111