111111111
1P1C000E1
110000001
100000001
111111111