111111111
1P0C000E1
100000001
1000C0001
111111111