NO ./wolftex/textures/xpm/greystone.xpm
SO ./wolftex/textures/xpm/redbrick.xpm
EA ./wolftex/textures/xpm/wood.xpm
WE ./wolftex/textures/xpm/wood.xpm
C 255,200,160
F 122,122,122

                                                        111111
                                                        11020111111111
                11111111111111111                       11000000000001
                100000000000000011111111111111111111111111020020020021
                102000002000002000000000000000000000000000000000000001
                100000000000000011111111111111111001111111111111011111
                10002000200020001               1001           101
                10000000000000001               1001           101111111111111111
                10202020N02020201               1001           100000000000000001
                10000000000000001           111110011111       111111111111111101
                10002000200200001           100000000001                      101
                10000000000000001           100000000001                      101
                10200000200002001111111111111000200200011111111111111111111111101
                10000000000000000000000000000000000000000000000000000000000000001
                11111011111111111111111111111000200200011111111111111111111111101
                    101                     100000000001                      101
                11111011111111111           100000000001                      101
                10000000000000001           111110011111                      101
                10200000200000201               1001                          101
                10000000000000001111111111111111100111111111111111111111111111101
                10002000200020000000000000000000000000000000000000000000000000001
                10000000000000001111111111111111111111111111111111111111111111111
                10202020002020201
                10000000000000001                                                                   1111
                10002000200200001                                                                   1001
                10000000000000001                                                                   1111
                10200000200002001111111111111
                10000000000000000000000000001
                11111111111111111111111111101
                                         11011
                                        11000111111111
11111111111111111                       11000000000001
100000000000000011111111111111111111111111020020020021
102000002000002000000000000000000000000000000000000001
100000000000000011111111111111111001111111111111011111
10002000200020001               1001           101
10000000000000001               1001           101111111111111111
10202020002020201               1001           100000000000000001
10000000000000001           111110011111       111111111111111101
10002000200200001           100000000001                      101
10000000000000001           100000000001                      101
10200000200002001111111111111000200200011111111111111111111111101111111111111111111111111111111111111111111111111111111111111111111111111111111111111111111111111111111
10000000000000000000000000000000000000000000000000000000000000000000000000000000000000000000000000000000000000000000000000000000000000000000000000000000000000000000001
11111011111111111111111111111000200200011111111111111111111111101111111111111111111111111111111111111111111111111111111111111111111111111111111111111111111111111111111
    101                     100000000001                      101
11111011111111111           100000000001                      101
10000000000000001           111110011111            1         101
10200000200000201               1001                          101
10000000000000001111111111111111100111111111111111111111111111101
10002000200020000000000000000000000000000000000000000000000000001
10000000000000001111111111111111111111111111111111111111111111111
10202020002020201
10000000000000001                               1
10002000200200001                                                                           1
10000000000000001
10200000200002001                           1
10000000000000001
11111111111111111
111111                                                          1
1111                            1
111                 1
11                                          1
1
1
1















































                                                                            1111
                                                                            1001
                                                                            1111


                                                            1111
                                                            1001
                                                            1111

                                            1111
                                            1001
                                            1111

                                1111
                                1001
                                1111

                    1111
                    1001
                    1111
        1111
        1001
        1111

1111
1001
1111
